4 13 31
###############################
#p    * **    *   3   4       #
# # # #*# # # # # # # # # # # #
#      ** * *  *   * ** 3 *   #
# # # # # #*# # #x# # # #*# # #
#*   * *f   *b* *   **        #
# # # # # # # # # # # # # #*# #
#    *     *        *    **  3#
# #*# # #*#*#*#*# # #1# # #*# #
#        * 4 *2*    *   *     #
#*# # # # # # # # # # #*# # #*#
#**    * **    ** ***     1   #
###############################