2 13 31
###############################
#p * *2       *  ** * *      *#
# # #b# #*# # #*# # # # # #*# #
#    * * *** **      *    **  #
# #*# # # # #1# # #1# # # # #*#
#          *     **      *  **#
# # #*# # # #*# #*#*#*#*# # # #
#   *        *   * *** *      #
# # # # #*###*# # # # #*#*#*# #
#   ****         *1 *x        #
# # ### # # # # # #*# # # # #*#
#  ** *   *    2              #
###############################
