3 13 31
###############################
#p   ** **    *   2           #
# # # #*# # # # # # # # # # # #
#*     ** * *  *   * x* 3 *   #
# # # # # #*# # # # # # #*# # #
#*   *s*    *** *  **         #
# # # # # # # # # # # # # #*# #
#    *     *  *s    *    **  3#
# #*# # #*#*#*#*# # #1# # #*# #
# *2     *   *2*    * * *     #
#*# # # # # # # # # # #*# # #*#
# *    * **    ** ***     1   #
###############################
