3 13 31
###############################
#p   **  *    *   2           #
# # # #*# # # # # # # # # # # #
#*     ** * *  *   * x* 3 *   #
# # # # # #*# # # # # # #*# # #
#*   *s*    *** * # **        #
# # # # # # # # # # # # # #*# #
#    *     *   1    *    **  3#
# #*# # #*#*#*#*# # #1# # #*# #
#    #   *   *2* *  *   *     #
#*# # # # # # # # # # #*# # #*#
# *    * ** *  ** ***     1   #
###############################
