4 13 31
###############################
#p    * **    *   3   4       #
# # # #*# # # # # # # # # # # #
#      ** * *  *   * ** 3 *   #
# # # # # #*# # # # # # #*# # #
#*   * *  * *b* *   **        #
# # # # # # # # # # # # # #*# #
#    *   * *  *     *    **  3#
# #*# # #*#*#*#*# # #1# # #*# #
#        *  *2*  4  *   *     #
#*# # # # # # #*# # # #*# # #*#
#x*    * **  * ** ***     1   #
###############################
